1111
1P01
1C01
1C01
1001
10E1
1111